10 10
7 7
5 3
##########
#        #
#  ### # #
##       #
###### ###
##X#     #
#  ####  #
# ##  S  #
#        #
##########