10 20
8 1
1 10
####################
##     ###X#     ###
## ### ##  ######  #
##                 #
###### #############
## #         ##### #
#  ####  ###       #
# ##   ### # #######
#S                 #
####################