10 10
##########
#        #
#  ### # #
##       #
###### ###
##X#     #
#  # ##  #
# ##  S  #
#        #
##########