8 10
##########
#    #  X#
###      #
###  #   #
#S  ### ##
### ### ##
#       ##
##########