5 6
######
#S S #
# S  #
#X  S#
######