10 20
8 1
1 4
####################
##  X  ### #     ###
## ### ##  ######  #
##                 #
####################
## #         ##### #
#  ####  ###       #
# ##   ### # #######
#S                 #
####################