8 10
4 3
1 9
##########
#    #  X#
###      #
###  #   #
# S ### ##
### ### ##
#       ##
##########